{
  "name": "level3",
  "author": "Tom",
  "next_level": "level4",
  "level_data": [
    ["0000", "0000", "0000", "0000", "0000", "0000", "0000", "0000", "0000", "0000", "0000", "0000", "0000", "0000", "0000", "0000", "0000", "0000", "0000", "0000", "0000", "0000", "0000", "0000", "0000", "0000", "0000", "0000", "0000", "0000", "0000", "0000", "0000", "0000", "0000", "0000", "0000", "0000", "0000", "0000", "0000", "0000", "0000", "0000", "0000", "0000", "0000", "0000", "0000", "0000", "0000", "0000", "0000", "0000", "0000", "0000", "0000", "0000", "0000", "0000", "0000", "0000", "0000", "0000", "0000", "0000", "0000", "0000", "0000", "0000", "0000", "0000", "0000", "0000", "0000", "0000", "0000", "0000", "0000", "0000", "0000", "0000", "0000", "0000", "0000", "0000", "0000", "0000", "0000", "0000", "0000", "0000", "0000", "0000", "0000", "0000", "0000", "0000", "0000", "0000", "0000", "0000", "0000", "0000", "0000", "0000", "0000", "0000", "0000", "0000", "0000", "0000", "0000", "0000", "0000", "0000", "0000", "0000", "0000", "0000", "0000", "0000", "0000", "0000", "0000", "0000", "0000", "0000", "0000", "0000", "0000", "0000", "0000", "0000", "0000", "0000", "0000", "0000", "0000", "0000", "0000", "0000", "0000", "0000", "0000", "0000", "0000", "0000", "0000", "0000"],
    ["0000", "0000", "0000", "0000", "0000", "0000", "0000", "0000", "0000", "0000", "0000", "0000", "0000", "0000", "0000", "0000", "0000", "0000", "0000", "0000", "0000", "0000", "0000", "0000", "0000", "0000", "0000", "0000", "0000", "0000", "0000", "0000", "0000", "0000", "0000", "0000", "0000", "0000", "0000", "0000", "0000", "0000", "0000", "0000", "0000", "0000", "0000", "0000", "0000", "0000", "0000", "0000", "0000", "0000", "0000", "0000", "0000", "0000", "0000", "0000", "0000", "0000", "0000", "0000", "0000", "0000", "0000", "0000", "0000", "0000", "0000", "0000", "0000", "0000", "0000", "0000", "0000", "0000", "0000", "0000", "0000", "0000", "0000", "0000", "0000", "0000", "0000", "0000", "0000", "0000", "0000", "0000", "0000", "0000", "0000", "0000", "0000", "0000", "0000", "0000", "0000", "0000", "0000", "0000", "0000", "0000", "0000", "0000", "0000", "0000", "0000", "0000", "0000", "0000", "0000", "0000", "0000", "0000", "0000", "0000", "0000", "0000", "0000", "0000", "0000", "0000", "0000", "0000", "0000", "0000", "0000", "0000", "0000", "0000", "0000", "0000", "0000", "0000", "0000", "0000", "0000", "0000", "0000", "0000", "0000", "0000", "0000", "0000", "0000", "0000"],
    ["0000", "0000", "0000", "0000", "0000", "0000", "0000", "0000", "0000", "0000", "0000", "0000", "0000", "0000", "0000", "0000", "0000", "0000", "0000", "0000", "0000", "0000", "0000", "0000", "0000", "0000", "0000", "0000", "0000", "0000", "0000", "0000", "0000", "0000", "0000", "0000", "0000", "0000", "0000", "0000", "0000", "0000", "0000", "0000", "0000", "0000", "0000", "0000", "0000", "0000", "0000", "0000", "0000", "0000", "0000", "0000", "0000", "0000", "0000", "0000", "0000", "0000", "0000", "0000", "0000", "0000", "0000", "0000", "0000", "0000", "0000", "0000", "0000", "0000", "0000", "0000", "0000", "0000", "0000", "0000", "0000", "0000", "0000", "0000", "0000", "0000", "0000", "0000", "0000", "0000", "0000", "0000", "0000", "0000", "0000", "0000", "0000", "0000", "0000", "0000", "0000", "0000", "0000", "0000", "0000", "0000", "0000", "0000", "0000", "0000", "0000", "0000", "0000", "0000", "0000", "0000", "0000", "0000", "0000", "0000", "0000", "0000", "0000", "0000", "0000", "0000", "0000", "0000", "0000", "0000", "0000", "0000", "0000", "0000", "0000", "0000", "0000", "0000", "0000", "0000", "0000", "0000", "0000", "0000", "0000", "0000", "0000", "0000", "0000", "0000"],
    ["0000", "0000", "0000", "0000", "0000", "0000", "0000", "0000", "0000", "0000", "0000", "0000", "0000", "0000", "0000", "0000", "0000", "0000", "0000", "0000", "0000", "0000", "0000", "0000", "0000", "0000", "0000", "0000", "0000", "0000", "0000", "0000", "0000", "0000", "0000", "0000", "0000", "0000", "0000", "0000", "0000", "0000", "0000", "0000", "0000", "0000", "0000", "0000", "0000", "0000", "0000", "0000", "0000", "0000", "0000", "0000", "0000", "0000", "0000", "0000", "0000", "0000", "0000", "0000", "0000", "0000", "0000", "0000", "0000", "0000", "0000", "0000", "0000", "0000", "0000", "0000", "0000", "0000", "0000", "0000", "0000", "0000", "0000", "0000", "0000", "0000", "0000", "0000", "0000", "0000", "0000", "0000", "0000", "0000", "0000", "0000", "0000", "0000", "0000", "0000", "0000", "0000", "0000", "0000", "0000", "0000", "0000", "0000", "0000", "0000", "0000", "0000", "0000", "0000", "0000", "0000", "0000", "0000", "0000", "0000", "0000", "0000", "0000", "0000", "0000", "0000", "0000", "0000", "0000", "0000", "0000", "0000", "0000", "0000", "0000", "0000", "0000", "0000", "0000", "0000", "0000", "0000", "0000", "0000", "0000", "0000", "0000", "0000", "0000", "0000"],
    ["0000", "0000", "0000", "0000", "0000", "0000", "0000", "0000", "0000", "0000", "0000", "0000", "0000", "0000", "0000", "0000", "0000", "0000", "0000", "0000", "0000", "0000", "0000", "0000", "0000", "0000", "0000", "0000", "0000", "0000", "0000", "0000", "0000", "0000", "0000", "0000", "0000", "0000", "0000", "0000", "0000", "0000", "0000", "0000", "0000", "0000", "0000", "0000", "0000", "0000", "0000", "0000", "0000", "0000", "0000", "0000", "0000", "0000", "0000", "0000", "0000", "0000", "0000", "0000", "0000", "0000", "0000", "0000", "0000", "0000", "0000", "0000", "0000", "0000", "0000", "0000", "0000", "0000", "0000", "0000", "0000", "0000", "0000", "0000", "0000", "0000", "0000", "0000", "0000", "0000", "0000", "0000", "0000", "0000", "0000", "0000", "0000", "0000", "0000", "0000", "0000", "0000", "0000", "0000", "0000", "0000", "0000", "0000", "0000", "0000", "0000", "0000", "0000", "0000", "0000", "0000", "0000", "0000", "0000", "0000", "0000", "0000", "0000", "0000", "0000", "0000", "0000", "0000", "0000", "0000", "0000", "0000", "0000", "0000", "0000", "0000", "0000", "0000", "0000", "0000", "0000", "0000", "0000", "0000", "0000", "0000", "0000", "0000", "0000", "0000"],
    ["0000", "0000", "0000", "0000", "0000", "0000", "0000", "0000", "0000", "0000", "0000", "0000", "0000", "0000", "0000", "0000", "0000", "0000", "0000", "0000", "0000", "0000", "0000", "0000", "0000", "0000", "0000", "0000", "0000", "0000", "0000", "0000", "0000", "0000", "0000", "0000", "0000", "0000", "0000", "0000", "0000", "0000", "0000", "0000", "0000", "0000", "0000", "0000", "0000", "0000", "0000", "0000", "0000", "0000", "0000", "0000", "0000", "0000", "0000", "0000", "0000", "0000", "0000", "0000", "0000", "0000", "0000", "0000", "0000", "0000", "0000", "0000", "0000", "0000", "0000", "0000", "0000", "0000", "0000", "0000", "0000", "0000", "0000", "0000", "0000", "0000", "0000", "0000", "0000", "0000", "0000", "0000", "0000", "0000", "0000", "0000", "0000", "0000", "0000", "0000", "0000", "0000", "0000", "0000", "0000", "0000", "0000", "0000", "0000", "0000", "0000", "0000", "0000", "0000", "0000", "0000", "0000", "0000", "0000", "0000", "0000", "0000", "0000", "0000", "0000", "0000", "0000", "0000", "0000", "0000", "0000", "0000", "0000", "0000", "0000", "0000", "0000", "0000", "0000", "0000", "0000", "0000", "0000", "0000", "0000", "0000", "0000", "0000", "0000", "0000"],
    ["0000", "0000", "0000", "0000", "0000", "0000", "0000", "0000", "0000", "0000", "0000", "0000", "0000", "0000", "0000", "0000", "0000", "0000", "0000", "0000", "0000", "0000", "0000", "0000", "0000", "0000", "0000", "0000", "0000", "0000", "0000", "0000", "0000", "0000", "0000", "0000", "0000", "0000", "0000", "0000", "0000", "0000", "0000", "0000", "0000", "0000", "0000", "0000", "0000", "0000", "0000", "0000", "0000", "0000", "0000", "0000", "0000", "0000", "0000", "0000", "0000", "0000", "0000", "0000", "0000", "0000", "0000", "0000", "0000", "0000", "0000", "0000", "0000", "0000", "0000", "0000", "0000", "0000", "0000", "0000", "0000", "0000", "0000", "0000", "0000", "0000", "0000", "0000", "0000", "0000", "0000", "0000", "0000", "0000", "0000", "0000", "0000", "0000", "0000", "0000", "0000", "0000", "0000", "0000", "0000", "0000", "0000", "0000", "0000", "0000", "0000", "0000", "0000", "0000", "0000", "0000", "0000", "0000", "0000", "0000", "0000", "0000", "0000", "0000", "0000", "0000", "0000", "0000", "0000", "0000", "0000", "0000", "0000", "0000", "0000", "0000", "0000", "0000", "0000", "0000", "0000", "0000", "0000", "0000", "0000", "0000", "0000", "0000", "0000", "0000"],
    ["0000", "0000", "0000", "0000", "0000", "0000", "0000", "0000", "0000", "0000", "0000", "0000", "0000", "0000", "0000", "0000", "0000", "0000", "0000", "0000", "0000", "0000", "0000", "0000", "0000", "0000", "0000", "0000", "0000", "0000", "0000", "0000", "0000", "0000", "0000", "0000", "0000", "0000", "0000", "0000", "0000", "0000", "0000", "0000", "0000", "0000", "0000", "0000", "0000", "0000", "0000", "0000", "0000", "0000", "0000", "0000", "0000", "0000", "0000", "0000", "0000", "0000", "0000", "0000", "0000", "0000", "0000", "0000", "0000", "0000", "0000", "0000", "0000", "0000", "0000", "0000", "0000", "0000", "0000", "0000", "0000", "0000", "0000", "0000", "0000", "0000", "0000", "0000", "0000", "0000", "0000", "0000", "0000", "0000", "0000", "0000", "0000", "0000", "0000", "0000", "0000", "0000", "0000", "0000", "0000", "0000", "0000", "0000", "0000", "0000", "0000", "0000", "0000", "0000", "0000", "0000", "0000", "0000", "0000", "0000", "0000", "0000", "0000", "0000", "0000", "0000", "0000", "0000", "0000", "0000", "0000", "0000", "0000", "0000", "0000", "0000", "0000", "0000", "0000", "0000", "0000", "0000", "0000", "0000", "0000", "0000", "0000", "0000", "0000", "0000"],
    ["0000", "0000", "0000", "0000", "0000", "0000", "0000", "0000", "0000", "0000", "0000", "0000", "0000", "0000", "0000", "0000", "0000", "0000", "0000", "0000", "0000", "0000", "0000", "0000", "0000", "0000", "0000", "0000", "0000", "0000", "0000", "0000", "0000", "0000", "0000", "0000", "0000", "0000", "0000", "0000", "0000", "0000", "0000", "0000", "0000", "0000", "0000", "0000", "0000", "0000", "0000", "0000", "0000", "0000", "0000", "0000", "0000", "0000", "0000", "0000", "0000", "0000", "0000", "0000", "0000", "0000", "0000", "0000", "0000", "0000", "0000", "0000", "0000", "0000", "0000", "0000", "0000", "0000", "0000", "0000", "0000", "0000", "0000", "0000", "0000", "0000", "0000", "0000", "0000", "0000", "0000", "0000", "0000", "0000", "0000", "0000", "0000", "0000", "0000", "0000", "0000", "0000", "0000", "0000", "0000", "0000", "0000", "0000", "0000", "0000", "0000", "0000", "0000", "0000", "0000", "0000", "0000", "0000", "0000", "0000", "0000", "0000", "0000", "0000", "0000", "0000", "0000", "0000", "0000", "0000", "0000", "0000", "0000", "0000", "0000", "0000", "0000", "0000", "0000", "0000", "0000", "0000", "0000", "0000", "0000", "0000", "0000", "0000", "0000", "0000"],
    ["0000", "0000", "0000", "0000", "0000", "0000", "0000", "0000", "1011", "1802", "1013", "0000", "0000", "0000", "0000", "0000", "0000", "0000", "0000", "0000", "0000", "0000", "0000", "0000", "0000", "0000", "0000", "0000", "0000", "0000", "0000", "0000", "0000", "0000", "0000", "0000", "0000", "0000", "0000", "0000", "0000", "0000", "0000", "0000", "0000", "0000", "0000", "0000", "0000", "0000", "0000", "0000", "0000", "0000", "0000", "0000", "0000", "0000", "0000", "0000", "0000", "0000", "0000", "0000", "0000", "0000", "0000", "0000", "0000", "0000", "0000", "0000", "0000", "0000", "0000", "0000", "0000", "0000", "0000", "0000", "0000", "0000", "0000", "0000", "0000", "0000", "0000", "0000", "0000", "0000", "0000", "0000", "0000", "0000", "0000", "0000", "0000", "0000", "0000", "0000", "0000", "0000", "0000", "0000", "0000", "0000", "0000", "0000", "0000", "0000", "0000", "0000", "0000", "0000", "0000", "0000", "0000", "0000", "0000", "0000", "0000", "0000", "0000", "0000", "0000", "0000", "0000", "0000", "0000", "0000", "0000", "0000", "0000", "0000", "0000", "0000", "0000", "0000", "0000", "0000", "0000", "0000", "0000", "0000", "0000", "0000", "0000", "0000", "0000", "0000"],
    ["0000", "0000", "0000", "0000", "0000", "0000", "0000", "1011", "1012", "1800", "1014", "1013", "0000", "0000", "0000", "0000", "0000", "0000", "0000", "0000", "0000", "0000", "0000", "0000", "0000", "0000", "0000", "0000", "0000", "0000", "0000", "0000", "0000", "0000", "0000", "0000", "0000", "0000", "0000", "0000", "0000", "0000", "0000", "0000", "0000", "0000", "0000", "0000", "0000", "0000", "0000", "0000", "0000", "0000", "0000", "0000", "0000", "0000", "0000", "0000", "0000", "0000", "0000", "0000", "0000", "0000", "0000", "0000", "0000", "0000", "0000", "0000", "0000", "0000", "0000", "0000", "0000", "0000", "0000", "0000", "0000", "0000", "0000", "0000", "0000", "0000", "0000", "0000", "0000", "0000", "0000", "0000", "0000", "0000", "0000", "0000", "0000", "0000", "0000", "0000", "0000", "0000", "0000", "0000", "0000", "0000", "0000", "0000", "0000", "0000", "0000", "0000", "0000", "0000", "0000", "0000", "0000", "0000", "0000", "0000", "0000", "0000", "0000", "0000", "0000", "0000", "0000", "0000", "0000", "0000", "0000", "0000", "0000", "0000", "0000", "0000", "0000", "0000", "0000", "0000", "0000", "0000", "0000", "0000", "0000", "0000", "0000", "0000", "0000", "0000"],
    ["0000", "0000", "0000", "0000", "0000", "0000", "1011", "1012", "1001", "1800", "1001", "1014", "1013", "0000", "0000", "0000", "0000", "0000", "0000", "0000", "0000", "0000", "0000", "0000", "0000", "0000", "0000", "0000", "0000", "0000", "0000", "0000", "0000", "0000", "0000", "0000", "0000", "0000", "0000", "0000", "0000", "0000", "0000", "0000", "0000", "0000", "0000", "0000", "0000", "0000", "0000", "0000", "0000", "0000", "0000", "0000", "0000", "0000", "0000", "0000", "0000", "0000", "0000", "0000", "0000", "0000", "0000", "0000", "0000", "0000", "0000", "0000", "0000", "0000", "0000", "0000", "0000", "0000", "0000", "0000", "0000", "0000", "0000", "0000", "0000", "0000", "0000", "0000", "0000", "0000", "0000", "0000", "0000", "0000", "0000", "0000", "0000", "0000", "0000", "0000", "0000", "0000", "0000", "0000", "0000", "0000", "0000", "0000", "0000", "0000", "0000", "0000", "0000", "0000", "0000", "0000", "0000", "0000", "0000", "0000", "0000", "0000", "0000", "0000", "0000", "0000", "0000", "0000", "0000", "0000", "0000", "0000", "0000", "0000", "0000", "0000", "0000", "0000", "0000", "0000", "0000", "0000", "0000", "0000", "0000", "0000", "0000", "0000", "0000", "0000"],
    ["0000", "0000", "0000", "0000", "0000", "1011", "1012", "1001", "1800", "1800", "1800", "1001", "1014", "1013", "0000", "0000", "0000", "0000", "0000", "0000", "0000", "0000", "0000", "0000", "0000", "0000", "0000", "0000", "0000", "0000", "0000", "0000", "0000", "0000", "0000", "0000", "0000", "0000", "0000", "0000", "0000", "0000", "0000", "0000", "0000", "0000", "0000", "0000", "0000", "0000", "0000", "0000", "0000", "0000", "0000", "0000", "0000", "0000", "0000", "0000", "0000", "0000", "0000", "0000", "0000", "0000", "0000", "0000", "0000", "0000", "0000", "0000", "0000", "0000", "0000", "0000", "0000", "0000", "0000", "0000", "0000", "0000", "0000", "0000", "0000", "0000", "0000", "0000", "0000", "0000", "0000", "0000", "0000", "0000", "0000", "0000", "0000", "0000", "0000", "0000", "0000", "0000", "0000", "0000", "0000", "0000", "0000", "0000", "0000", "0000", "0000", "0000", "0000", "0000", "0000", "0000", "0000", "0000", "0000", "0000", "0000", "0000", "0000", "0000", "0000", "0000", "0000", "0000", "0000", "0000", "0000", "0000", "0000", "0000", "0000", "0000", "0000", "0000", "0000", "0000", "0000", "0000", "0000", "0000", "0000", "0000", "0000", "0000", "0000", "0000"],
    ["0000", "0000", "0000", "0000", "1011", "1012", "1001", "1800", "1800", "1800", "1800", "1800", "1001", "1014", "1013", "0000", "0000", "0000", "0000", "0000", "0000", "0000", "0000", "0000", "0000", "0000", "0000", "0000", "0000", "0000", "0000", "0000", "0000", "0000", "0000", "0000", "0000", "0000", "0000", "0000", "0000", "0000", "0000", "0000", "0000", "0000", "0000", "0000", "0000", "0000", "0000", "0000", "0000", "0000", "0000", "0000", "0000", "0000", "0000", "0000", "0000", "0000", "0000", "0000", "0000", "0000", "0000", "0000", "0000", "0000", "0000", "0000", "0000", "0000", "0000", "0000", "0000", "0000", "0000", "0000", "0000", "0000", "0000", "0000", "0000", "0000", "0000", "0000", "0000", "0000", "0000", "0000", "0000", "0000", "0000", "0000", "0000", "0000", "0000", "0000", "0000", "0000", "0000", "0000", "0000", "0000", "0000", "0000", "0000", "0000", "0000", "0000", "0000", "0000", "0000", "0000", "0000", "0000", "0000", "0000", "0000", "0000", "0000", "0000", "0000", "0000", "0000", "0000", "0000", "0000", "0000", "0000", "0000", "0000", "0000", "0000", "0000", "0000", "0000", "0000", "0000", "0000", "0000", "0000", "0000", "0000", "0000", "0000", "0000", "0000"],
    ["0000", "0001", "1913", "1011", "1012", "1001", "1001", "1800", "1800", "1800", "1800", "1800", "1001", "1001", "1014", "1013", "0000", "1912", "1904", "0000", "0000", "0000", "0000", "0000", "0000", "0000", "0000", "0000", "0000", "0000", "0000", "0000", "0000", "0000", "0000", "0000", "0000", "0000", "0000", "0000", "0000", "0000", "0000", "0000", "0000", "0000", "0000", "0000", "0000", "0000", "0000", "0000", "0000", "0000", "0000", "0000", "0000", "0000", "0000", "0000", "0000", "0000", "0000", "0000", "0000", "0000", "0000", "0000", "0000", "0000", "0000", "0000", "0000", "0000", "0000", "0000", "0000", "0000", "0000", "0000", "0000", "0000", "0000", "0000", "0000", "0000", "0000", "0000", "0000", "0000", "0000", "0000", "0000", "0000", "0000", "0000", "0000", "0000", "0000", "0000", "0000", "0000", "0000", "0000", "0000", "0000", "0000", "0000", "0000", "0000", "0000", "0000", "0000", "0000", "0000", "0000", "0000", "0000", "0000", "0000", "0000", "0000", "0000", "0000", "0000", "0000", "0000", "0000", "0000", "0000", "0000", "0000", "0000", "0000", "0000", "0000", "0000", "0000", "0000", "0000", "0000", "0000", "0000", "0000", "0000", "0000", "0000", "0000", "0000", "0000"],
    ["1016", "1016", "1016", "1012", "1001", "1001", "1800", "1800", "1800", "1800", "1800", "1800", "1800", "1001", "1001", "1014", "1016", "1016", "1016", "1016", "1016", "1016", "1016", "1016", "1016", "1016", "1016", "1016", "1016", "1016", "1016", "1016", "1016", "1016", "1016", "1016", "1016", "1016", "1016", "1016", "1016", "1016", "1016", "1016", "1016", "1016", "1016", "1016", "1016", "1016", "1016", "1016", "1016", "1016", "1016", "1016", "1016", "1016", "1016", "1016", "1016", "1016", "1016", "1016", "1016", "1016", "1016", "1016", "1016", "1016", "1016", "1016", "1016", "1016", "1016", "1016", "1016", "1016", "1016", "1016", "1016", "1016", "1016", "1016", "1016", "1016", "1016", "1016", "1016", "1016", "1016", "1016", "1016", "1016", "1016", "1016", "1016", "1016", "1016", "1016", "1016", "1016", "1016", "1016", "1016", "1016", "1016", "1016", "1016", "1016", "1016", "1016", "1016", "1016", "1016", "1016", "1016", "1016", "1016", "1016", "1016", "1016", "1016", "1016", "1016", "1016", "1016", "1016", "1016", "1016", "1016", "1016", "1016", "1016", "1016", "1016", "1016", "1016", "1016", "1016", "1016", "1016", "1016", "1016", "1016", "1016", "1016", "1016", "1016", "1016"]
  ]
}